OOOOOOOWOOOOOWB
OWWWWWOWOWWWOWO
OWOOOWOWOWOOOWO
OOOWOWOOOWOWWWO
WWOWOWWWOWOOOOO
OWOWOWOWOWWWWWW
OWOWOWOOOOOOOOO
OWWWOWWOWWWWWWW
OOOOOOWOWOOOOOO
OWWWWWWOWOWWWWO
OOWOOOWWWWWOOOO
OWWOWOOOOOWOWWW
OOOOWOWWWOWOOOW
WWWOWOOOWOWWWOW
AOOOWOWWWOOOOOW